WWWWWWWWWWWWWWWWWWWWWWWWW
W  w   w W wddWp W ww WdW
W WwW  w  WwdwW dw  Ww  W
W  d  WwW wwW  w w W wWWW
W WwW  pwdW p  w WW  Wp W
W Pd   ww  w w   P wW   W
W WwW WWWW  W W W  w wW W
WwwdP w dww   P   W  W WW
W WwWwW d  w    ww  W   W
W   w   W   W w W  w wW W
W WwW W  WW P   P W  W  W
W  w    w  w w w w  W wWW
W PW  wW P  W WWwW W w  W
W  w PWWpWWddw   pwp WwdW
WWWWWWWWWWWWWWWWWWWWWWWWW