WWWWWWWWWWWWWWWWWWWWWWWWW
W    w       wd P WW  w W
W    wd  PWW pWWW d  pw W
WWwWWWWWwWWWwwWWWWwWWWW W
WWwWWWWWwWWWWwWwWWwWWWWwW
Wdw WW  w WW wp  ww W   W
W  P  w   P    w wwP  w W
W WW p WW   WW WW  dwddwW
WdWWWWWWWWWWWWWWWWWWWWWWW
W WW W pwW W W Wdw  wW  W
W W   wW P w  w WW W dW W
W w wpw wW wWW w wpWwW WW
W w W W W w W pW  wW   PW
W pWwP dWW w w dwW  wWW W
WWWWWWWWWWWWWWWWWWWWWWWWW