WWWWWWWWWWWWWWWWWWWWWWWWW
W   w  www ww     Pw    W
W W W WdWwW WWp  W W WWwW
W   P www ww w Wwdw  ww W
WwW W Wwd   PwW  W WW W W
W wwww wdww W w W    W WW
W W WwW W WW  P   W  P  W
Ww p w  w    W wWw W  WWW
WwW  W w w W   Wd w W w W
Ww  W  W  W  W WW W  W  W
W W w w w  Ww p  w w W WW
W ww   W   w  W   WW  W W
WW p W w Ww W w W wdWw  W
W  W   w  P  W w  W w  pW
WWWWWWWWWWWWWWWWWWWWWWWWW