WWWWWWWWWWWWWWWWWWWWWWWWW
W   Ww pWw pwW WWP w wPwW
W  w    w          w   wW
WwWWWWWWWWWWWWWWWWWWWW  W
W  Ww W wdw    w p   W  W
WwdWdW w   dWP  wwdW WW W
W WW  w  W  w w w    WwwW
Wp Wp wP WP WdWdwWPw W  W
WWwW  w  W  w wdw    dwpW
WW WdW w   dWP  wwdW dwWW
W  Ww W wdw    w p   W  W
W  WWWWWWWWWWWWWWWWWWW  W
W PW pwdW WW Pdw pdw  P W
Wd w   ww      w  wdW  dW
WWWWWWWWWWWWWWWWWWWWWWWWW